おだむどう	織田無道	人名	
せふぃろす	セフィロス	人名	
えむすて	Mステ	固有名詞	
えむすて	ミュージックステーション	短縮よみ	
ぜんべいじょしおーぷん	全米女子オープン	名詞	
たなかけい	田中圭	人名	
しんかいしゃくさんごくし	新解釈・三國志	固有名詞	
ゔぃっせるこうべ	ヴィッセル神戸	固有名詞	
のざわおんせんむら	野沢温泉村	地名	
おおしまゆうこ	大島優子	人名	
ふたござりゅうせいぐん	ふたご座流星群	名詞	
きむぎどく	キム・キドク	人名	
きむぎどく	金基德	人名	
きむぎどく	김기덕	人名	
もんすと	もんすと	固有名詞	
はこねえきでん	箱根駅伝	固有名詞	
さいばーぱんく	サイバーパンク	固有名詞	
さいばーぱんく2077	サイバーパンク2077	固有名詞	
さいばーぱんく	Cyberpunk	固有名詞	
さいばーぱんく2077	Cyberpunk 2077	固有名詞	
あすとろしてぃみに	アストロシティミニ	固有名詞	
ほんこんかっぷ	香港カップ	名詞	
のーむこあ	ノームコア	固有名詞	
あかしやさんま	明石家さんま	人名	
こうしえんぼうる	甲子園ボウル	固有名詞	
にしかわたかのり	西川貴教	人名	
べすとぼでぃじゃぱん	ベストボディ・ジャパン	固有名詞	
べすとぼでぃじゃぱん	BEST BODY JAPAN	固有名詞	
けいわん	K-1	固有名詞	
けーわん	K-1	固有名詞	
ほんこんまいる	香港マイル	固有名詞	
ごーるでんしっくすてぃ	ゴールデンシックスティ	固有名詞	
ゆーちゅーぶ	YouTube	固有名詞	
おざわれん	小澤廉	人名	
ごーとぅーとらべる	Go Toトラベル	固有名詞	
ことしのかんじ	今年の漢字	名詞	
ちぇんそーまん	チェンソーマン	固有名詞	
ぐーぐる	Google	組織	
つまぶきさとし	妻夫木聡	人名	
はまべみなみ	浜辺美波	人名	
さくらかくめい	サクラ革命	固有名詞	
じぇいてぃーびー	JTB	組織	
かいんず	カインズ	組織	
かいんず	CAINZ	組織	
ちゃんぴおんずりーぐ	チャンピオンズリーグ	名詞	
でぃーえいちしー	DHC	組織	
じぇいつー	J2	固有名詞	
じぇいつー	明治安田生命J2リーグ	短縮よみ	
めいじやすだせいめいじぇいつーりーぐ	明治安田生命J2リーグ	固有名詞	
ゆうゆうはくしょ	幽☆遊☆白書	固有名詞	
みやざきよしこ	宮崎美子	人名	
あまんぐあす	Among Us	固有名詞	
じぇいりーぐ	Jリーグ	固有名詞	
ゔりとら	ヴリトラ	固有名詞	
ばるみゅーだ	バルミューダ	組織	
ばるみゅーだ	BALMUDA	組織	
せんとちひろのかみかくし	千と千尋の神隠し	固有名詞	
とうきょうりべんじゃーず	東京卍リベンジャーズ	固有名詞	
かんじゃにえいと	関ジャニ∞	固有名詞	
ぷーさんのほーむらんだーびー	プーさんのホームランダービー！	固有名詞	
じしん	地震	名詞	
げんしん	原神	固有名詞	
しばさきこう	柴咲コウ	人名	
はまざきあゆみ	浜崎あゆみ	人名	
ことしのかんじ	今年の漢字	名詞	
かたせなな	片瀬那奈	人名	
よこやまほっとぶらざーず	横山ホットブラザーズ	固有名詞	
しんがたころなういるすかんせんしょう	新型コロナウイルス感染症	名詞	
しんがたころなういるすかんせんしょう	COVID-19	名詞	
こゔぃっど19	COVID-19	名詞	
しんがたころなういるす	新型コロナウイルス	名詞	
しんがたころなういるす	SARS-CoV-2	名詞	
さーずこぶ2	SARS-CoV-2	名詞	
だいとうりょうせんきょ	大統領選挙	名詞	
きめつのやいば	鬼滅の刃	固有名詞	
あつまれどうぶつのもり	あつまれ どうぶつの森	固有名詞	
ごーとぅー	Go To	短縮よみ	
ずーむ	Zoom	名詞	
きんきゅうじたいせんげん	緊急事態宣言	名詞	
とうきょうあらーと	東京アラート	名詞	
ころなういるす	コロナウイルス	名詞	
ろっくだうん	ロックダウン	名詞	
ぱんでみっく	パンデミック	名詞	
こくせいちょうさ	国勢調査	名詞	
てれわーく	テレワーク	名詞	
どこもこうざ	ドコモ口座	固有名詞	
ごーとぅーきゃんぺーん	Go Toキャンペーン	名詞	
おーばーしゅーと	オーバーシュート	名詞	
あべのますく	アベノマスク	名詞	
みうらはるま	三浦春馬	人名	
たけうちゆうこ	竹内結子	人名	
しむらけん	志村けん	人名	
あしなせい	芦名星	人名	
ますく	マスク	名詞	
ますくかばー	マスクカバー	名詞	
あるこーるしょうどくえき	アルコール消毒液	名詞	
えこばっぐ	エコバッグ	名詞	
にっしょくぐらす	日食グラス	名詞	
じあえんそさんすい	次亜塩素酸水	名詞	
はっかゆすぷれー	ハッカ油スプレー	名詞	
ふぇいすしーるど	フェイスシールド	名詞	
うりあげだいちょう	売上台帳	名詞	
おりがみまんげきょう	折り紙万華鏡	名詞	
きゅうふきん	給付金	名詞	
きゅうふきんしんせい	給付金申請	名詞	
まいなんばーかーど	マイナンバーカード	名詞	
まいなんばーかーどしんせい	マイナンバーカード申請	名詞	
こようちょうせいじょせいきん	雇用調整助成金	名詞	
こようちょうせいじょせいきんしんせい	雇用調整助成金申請	名詞	
あっぷでーと	アップデート	名詞	
ぴーしーあーるけんさ	PCR検査	名詞	
きゅうぎょうてあて	休業手当	名詞	
じっこうさいせいさんすう	実効再生産数	名詞	
めんきょこうしん	免許更新	名詞	
きめつのやいばむげんれっしゃへん	「鬼滅の刃」無限列車編	固有名詞	
ぱらさいとはんちかのかぞく	パラサイト 半地下の家族	固有名詞	
となりのととろ	となりのトトロ	固有名詞	
きょうからおれは	今日から俺は!!	固有名詞	
こんふぃでんすまんじぇーぴーぷりんせすへん	コンフィデンスマンJP プリンセス編	固有名詞	
かいじふぁいなるげーむ	カイジ ファイナルゲーム	固有名詞	
いぬなきむら	犬鳴村	固有名詞	
こくりこざかから	コクリコ坂から	固有名詞	
こえのかたち	聲の形	固有名詞	
みっどさまー	ミッドサマー	固有名詞	
てせうすのふね	テセウスの船	固有名詞	
はんざわなおき	半沢直樹	固有名詞	
えーる	エール	固有名詞	
こいはつづくよどこまでも	恋はつづくよどこまでも	固有名詞	
すかーれっと	スカーレット	固有名詞	
きりんがくる	麒麟がくる	固有名詞	
みゅーよんまるよん	MIU404	固有名詞	
わたしたちはどうかしている	私たちはどうかしている	固有名詞	
わたしのかせいふなぎささん	私の家政夫ナギサさん	固有名詞	
あいのふじちゃく	愛の不時着	固有名詞	
ごくせん	ごくせん	固有名詞	
じん	JIN-仁-	固有名詞	
すぺっく	SPEC～警視庁公安部公安第五課 未詳事件特別対策係事件簿～	短縮よみ	
すぺっくけいしちょうこうあんぶだい5かみしょうじけんとくべつたいさくがかりじけんぼ	SPEC～警視庁公安部公安第五課 未詳事件特別対策係事件簿～	固有名詞	
にげるははじだがやくにたつ	逃げるは恥だが役に立つ	固有名詞	
やまとなでしこ	やまとなでしこ	固有名詞	
のぶたをぷろでゅーす	野ブタ。をプロデュース	固有名詞	
ちゅうがくせいにっき	中学聖日記	固有名詞	
しつれんしょこらてぃえ	失恋ショコラティエ	固有名詞	
あいしているといってくれ	愛していると言ってくれ	固有名詞	
のだめかんたーびれ	のだめカンタービレ	固有名詞	
かんえつじどうしゃどう	関越自動車道	固有名詞	
びっとこいん	ビットコイン	名詞	
かそうけんのおんな	科捜研の女	固有名詞	
ふぁんたじありびるど	ファンタジア・リビルド	固有名詞	
ごくせん2	ごくせん2	固有名詞	
もにたりんぐ	モニタリング	固有名詞	
とつぜんですがうらなってもいいですか	突然ですが占ってもいいですか	固有名詞	
